14 14 14 14 14 14 14 14 14 14 14 43 24 24 24 44 14 14 14 14 14 14 15 17 18 18 18 18 18 18 19 13 14 14 14 14 14 14 14 14 14 30 31 32 14 14 14 14 14 14 
14 14 30 31 32 14 14 14 14 14 14 15 7 8 9 13 14 14 0 1 2 14 15 17 18 18 18 18 18 18 19 13 14 14 14 14 14 14 14 14 14 40 41 42 14 43 24 24 44 14 
14 14 40 41 42 14 14 14 14 14 14 15 27 28 29 13 14 14 10 11 12 14 15 17 18 37 18 18 18 18 19 13 14 14 14 14 14 0 1 2 14 50 51 52 14 15 61 61 13 14 
14 14 50 51 52 14 14 14 14 14 14 53 4 4 4 54 14 14 20 21 22 14 15 17 18 18 18 18 18 18 19 13 14 14 14 14 14 10 11 12 14 14 14 14 14 15 61 61 13 14 
14 14 14 14 14 14 14 14 14 14 14 14 14 14 14 14 14 14 14 14 14 14 15 17 18 18 18 18 37 18 19 13 14 14 14 14 14 20 21 22 14 14 14 14 14 53 4 4 54 14 
24 24 24 24 24 44 14 43 24 24 24 24 24 24 24 24 24 24 24 24 24 24 25 27 28 28 28 28 28 28 29 23 24 24 24 24 24 24 24 24 24 24 44 14 14 14 14 14 14 14 
61 61 61 61 61 13 14 15 62 62 62 62 62 62 62 62 62 62 62 62 62 62 62 62 62 62 62 62 62 62 62 62 62 62 62 62 62 62 63 63 65 60 13 14 14 14 14 14 14 14 
61 61 61 61 61 13 14 15 62 62 62 62 62 62 62 62 62 62 62 62 62 62 62 62 62 62 62 62 62 62 62 62 62 62 62 62 63 62 62 62 6 64 13 14 14 43 24 24 44 14 
4 4 5 61 61 13 14 15 62 62 33 34 35 62 64 7 8 8 8 8 8 8 8 8 8 8 8 8 8 8 8 9 63 64 62 62 62 64 63 62 16 64 13 14 14 15 61 61 13 14 
14 14 15 61 61 13 14 15 62 62 62 62 62 62 65 17 18 18 18 18 18 18 18 18 18 18 18 18 18 18 18 57 38 68 62 62 63 62 63 62 26 63 13 14 14 15 61 61 13 14 
14 14 53 4 4 54 14 15 62 62 62 62 63 7 8 58 18 18 18 18 18 18 18 18 37 18 18 18 18 37 18 18 57 8 38 62 62 62 62 62 62 63 13 14 14 15 61 61 23 24 
14 14 14 14 14 14 14 15 62 62 62 62 63 17 18 18 18 37 18 18 18 18 18 18 18 18 18 18 18 18 18 18 18 18 57 8 8 9 62 62 62 62 13 14 14 15 61 61 61 61 
14 14 14 14 14 14 14 15 62 62 62 62 63 27 28 48 18 18 18 18 18 47 28 28 28 28 28 28 28 28 28 28 48 18 18 18 18 19 62 62 62 62 13 14 14 53 5 61 61 61 
14 14 14 14 14 14 43 25 62 62 62 62 63 63 65 27 48 18 18 18 47 29 65 63 65 65 68 68 64 63 63 67 39 18 18 18 37 19 62 62 62 62 13 14 14 14 53 4 4 4 
14 14 14 14 14 14 15 60 62 62 62 62 62 62 62 64 27 28 28 28 29 63 62 62 62 62 62 62 62 62 62 64 27 18 18 18 47 29 62 62 62 62 13 14 14 14 14 14 14 14 
14 14 14 14 14 14 15 60 62 62 62 62 62 45 62 63 63 65 63 64 63 63 62 62 62 62 62 62 62 62 62 62 62 27 28 28 29 62 62 62 62 62 13 14 14 14 14 14 14 14 
14 14 14 14 14 14 15 60 62 62 45 62 62 62 62 62 62 62 62 62 62 62 62 62 62 62 62 62 62 62 62 62 62 62 62 62 62 62 62 62 62 62 13 14 14 30 31 32 14 14 
14 14 14 14 14 14 53 5 62 62 62 62 62 62 62 45 62 62 62 62 62 62 62 62 62 33 34 34 34 34 35 63 62 62 62 62 62 62 62 62 62 62 13 14 14 40 41 42 14 14 
14 14 30 31 32 14 14 15 62 62 62 62 62 62 62 62 62 62 62 62 62 64 64 62 62 62 64 64 55 65 63 62 62 62 62 63 64 64 63 62 62 62 13 14 14 50 51 52 14 14 
14 14 40 41 42 14 14 15 62 62 62 62 62 62 62 62 62 62 62 62 64 64 64 62 62 62 62 62 62 62 62 62 62 62 33 34 34 34 35 62 62 62 13 14 14 14 14 14 14 14 
14 14 50 51 52 14 14 15 62 62 62 62 3 4 4 4 5 62 62 62 64 64 65 65 64 62 62 62 62 62 63 64 63 62 62 63 65 63 62 62 62 63 23 44 14 14 43 24 24 24 
24 24 24 24 24 24 44 15 62 62 6 62 13 0 1 2 15 62 62 62 62 64 65 55 65 64 62 62 63 33 34 35 63 62 62 62 62 62 62 62 62 62 55 13 14 14 15 61 61 61 
61 61 61 61 61 61 13 15 62 62 16 62 13 10 11 12 15 62 62 62 62 64 64 55 65 64 64 62 63 64 62 62 62 62 62 62 62 33 34 34 35 62 63 13 14 14 15 61 61 61 
4 4 4 4 5 61 13 15 62 62 16 62 13 20 21 22 15 62 62 62 62 62 62 64 64 64 64 62 62 62 62 62 62 62 62 62 62 62 63 64 62 62 63 13 14 14 53 4 5 61 
24 24 24 24 25 61 13 15 63 62 26 62 23 44 43 24 25 62 62 62 62 62 62 64 62 64 62 62 62 62 62 62 62 62 62 62 62 62 62 62 62 63 3 54 14 14 14 14 15 61 
61 61 61 61 61 61 13 15 68 62 62 62 62 13 15 60 67 62 62 62 3 4 4 4 4 4 4 4 4 4 4 4 4 4 4 4 4 5 62 62 62 62 13 14 14 14 14 14 15 61 
4 4 4 4 4 4 54 15 60 62 62 62 63 13 15 63 62 62 62 63 13 14 14 14 14 14 14 14 30 31 32 14 14 14 14 14 14 15 62 62 62 62 13 0 1 2 14 14 15 61 
14 14 14 14 14 14 14 15 63 63 62 62 68 13 15 63 62 62 62 63 13 14 14 14 14 14 14 14 40 41 42 14 14 14 14 14 14 15 62 62 62 62 13 10 11 12 14 14 15 61 
14 14 14 14 14 14 14 53 4 4 4 4 4 54 15 62 62 62 62 62 23 24 24 24 24 24 44 14 50 51 52 43 24 24 24 24 24 25 62 62 62 62 13 20 21 22 14 14 15 61 
14 14 14 14 14 14 14 14 14 14 14 14 14 14 15 63 62 62 62 62 62 62 62 62 62 49 13 14 14 43 24 25 60 62 62 62 62 62 62 62 62 63 13 14 14 14 14 43 25 61 
14 14 14 14 14 14 14 43 24 24 24 24 24 44 15 49 62 62 62 62 62 62 62 62 62 59 13 14 14 15 60 64 62 62 62 62 62 62 62 62 62 64 13 14 14 14 14 15 60 60 
14 14 14 14 14 14 14 15 68 68 63 60 67 13 15 59 62 62 62 62 62 62 62 62 62 69 13 14 14 15 64 62 62 62 62 62 62 62 62 62 62 64 23 44 14 43 24 25 60 61 
14 14 14 14 14 14 14 15 60 6 63 64 67 13 15 69 63 64 65 63 64 62 62 62 62 62 23 24 24 25 64 62 62 62 62 62 3 5 62 62 62 62 60 13 14 15 61 61 61 61 
14 14 14 30 31 32 14 15 63 16 63 63 67 13 53 4 4 4 4 4 5 62 62 62 62 62 62 62 62 62 62 62 62 62 63 65 13 15 62 62 62 62 64 13 14 15 60 61 61 3 
14 14 14 40 41 42 14 15 64 16 68 63 60 13 14 14 14 14 14 14 15 62 62 62 62 62 62 62 62 62 62 62 62 62 63 49 13 15 62 62 62 62 62 13 14 53 4 4 4 54 
14 14 14 50 51 52 14 15 68 26 63 64 67 23 24 24 24 24 24 24 25 62 62 62 62 3 4 4 4 4 5 62 62 62 63 59 13 53 4 4 5 62 62 13 14 30 31 32 14 14 
14 14 14 14 14 14 14 15 60 63 63 62 62 62 62 62 62 62 62 62 62 62 62 62 62 13 0 1 2 14 15 62 62 62 63 59 13 43 24 24 25 62 62 13 14 40 41 42 14 14 
14 14 14 14 14 14 14 15 64 62 62 62 62 62 62 62 62 62 63 65 63 62 62 62 62 13 10 11 12 14 15 6 62 62 63 69 13 15 60 63 63 62 62 13 14 50 51 52 14 14 
14 30 31 32 14 14 14 15 63 62 62 62 62 3 4 4 4 4 4 4 5 62 62 62 68 13 20 21 22 14 15 26 62 62 63 63 23 25 64 62 62 62 62 13 14 14 14 14 14 14 
14 40 41 42 14 14 14 15 62 62 62 62 65 13 14 14 14 14 14 14 15 62 62 62 64 13 14 14 14 14 15 64 62 62 62 62 62 62 62 62 62 62 63 13 14 14 14 14 14 14 
14 50 51 52 14 14 14 15 63 62 62 62 64 23 24 24 24 24 24 24 25 62 62 62 65 23 24 24 24 24 25 64 62 62 62 62 62 62 62 62 62 64 3 54 14 14 14 14 14 14 
14 14 14 14 14 14 14 15 55 62 62 62 63 64 63 62 62 62 64 65 63 62 62 62 62 62 62 62 62 64 55 65 62 62 62 62 62 62 62 63 64 60 13 14 14 14 14 14 14 14 
14 14 14 14 0 1 2 15 64 62 62 62 62 62 62 62 62 62 62 62 62 62 62 62 62 62 62 62 62 62 62 62 62 62 62 62 62 62 62 64 3 4 54 14 14 14 14 14 14 14 
14 14 14 14 10 11 12 15 63 63 62 64 65 62 62 62 62 63 63 62 64 63 62 62 62 62 62 62 62 62 62 62 62 62 62 62 62 64 64 60 13 14 14 14 14 14 14 14 14 14 
14 14 14 14 20 21 22 53 4 4 4 4 4 4 4 4 4 4 4 4 4 4 4 4 4 4 4 4 4 4 4 4 4 4 4 4 4 4 4 4 54 14 14 0 1 2 14 14 14 14 
14 14 14 14 14 14 14 14 14 14 14 14 14 43 24 24 24 44 14 14 14 14 14 30 31 32 14 14 14 14 14 14 14 14 14 14 14 14 14 14 14 14 14 10 11 12 14 14 14 14 
14 14 30 31 32 14 14 14 14 14 14 14 14 15 61 61 61 13 14 14 14 14 14 40 41 42 14 14 14 14 14 14 14 14 14 30 31 32 14 14 14 14 14 20 21 22 14 14 14 14 
14 14 40 41 42 14 14 14 14 14 14 14 14 53 4 4 4 54 14 14 14 14 14 50 51 52 14 14 14 14 14 14 14 14 14 40 41 42 14 14 14 14 14 14 14 14 14 14 14 14 
14 14 50 51 52 14 14 14 14 14 14 14 0 1 2 14 14 14 14 14 14 14 14 14 14 14 14 14 43 24 24 24 24 24 44 50 51 52 14 14 14 14 14 14 14 14 14 14 14 14 
14 14 14 14 14 14 14 14 14 14 14 14 10 11 12 14 14 14 14 14 14 14 14 14 14 14 14 14 15 7 8 8 8 9 13 14 14 14 14 14 14 14 14 14 14 14 14 14 14 14 
